{"timeLimit":60,"tiles":[
                         [0,0,0,0,2,6,2,0],
                         [0,0,0,2,6,2,0,0],
                         [0,0,2,6,2,0,0,0],
                         [0,2,6,2,0,0,0,0],
                         [2,6,2,0,0,0,0,0],
                         [0,2,6,2,0,0,0,0],
                         [0,0,2,6,2,0,0,0],
                         [0,0,0,2,6,2,0,0],
                         [0,0,0,0,2,6,2,0]],
    "spinningLog":[[190, 1300], [1300, 1700]]
}
