{"timeLimit":60,"tiles":[
                         [0,0,0,0,0,0,0,0],
                         [10,10,0,0,0,0,0,0],
                         [10,10,0,0,0,0,0,0],
                         [0,0,1,1,0,0,0,0],
                         [0,0,1,1,0,0,0,0],
                         [0,0,0,0,5,5,0,0],
                         [0,0,0,0,5,5,0,0],
                         [0,0,0,0,0,0,3,3],
                         [0,0,0,0,0,0,3,3]],
    "movingLog":[[400, 1620], [1700, 1220]]
}
