{"timeLimit":60,"tiles":[
                         [0,0,0,0,0,0,0,0],
                         [0,0,0,0,0,0,0,0],
                         [0,0,0,0,0,0,0,0],
                         [0,0,0,0,0,0,0,0],
                         [0,0,0,0,0,0,0,0],
                         [4,6,4,6,6,4,6,4],
                         [6,4,6,4,4,6,4,6],
                         [4,6,4,4,4,4,6,4],
                         [4,4,6,4,4,6,4,4]]
}
